1:Welcome Room
XXXXXXXXXXXXXXXXXXXXXXXXX
X                       X
X                       X
X                       X
X                       X
X                        
X                       X
X                       X
X                       X
X                       X
X                       X
XXXXXXXXXXX  XXXXXXXXXXXX
2:South Room
XXXXXXXXXXX  XXXXXXXXXXXX
X                       X
X                       X
X                       X
X                       X
X                       X
X                       X
X                       X
X                       X
X                       X
X                       X
XXXXXXXXXXXXXXXXXXXXXXXXX
3:East Room
XXXXXXXXXXXXXXXXXXXXXXXXX
X             XXXXXXXXXXX
X     XX      XXXXXXXXXXX
X      X      XXXXXXXXXXX
X      XX     XXXXXXXXXXX
              XXXXXXXXXXX
X                       X
X                       X
X                       X
X                       X
X                       X
XXXXXXXXXXXXXXXXXXXXXXXXX
